#################################
#                               #
#@=====v=====%=====<            #
#      |     |     |            #
#      |     |     |            #
#      |     >=====|===========*#
#      >===========^            #
#                               #
#################################
