############################################################################################
#                                                                                          #
#                                                                                          #
#                                                                                          #
#                                                                                          #
#@=====================v=========================================================%========<#
#                      |                                                         |         #
#                      |                                                         |         #
#                      |                                                         |         #
#                      |                                                         |         #
#                      |                                                         |         #
#                      v======%==================================================<         #
#                      |      |                                                            #
#                      |      |                                                            #
#                      |      |                                                            #
#                      |      |                                                            #
#                      >======>=======================v                                    #
#                                                     |                                    #
#                                                     |                                    #
#                                                     |                                    #
#                                                     |                                    #
#                                                     |                                    #
#                                                     |                                    #
#                                                     |                                    #
#                                                     |                                    #
#                                                     |                                    #
#                                                     |                                    #
#                                                     |                                    #
#                                                     |                                    #
#                                                     |                                    #
#                                                     |                                    #
#                                                     |                                    #
#                                                     |                                    #
#                                                     |                                    #
#                                                     *                                    #
############################################################################################
