#######
#  @  #
#  |  #
#  |  #
#  |  #
#  |  #
#  |  #
#  |  #
#  |  #
#  |  #
#  |  #
#  |  #
#  |  #
#  |  #
#  |  #
#  |  #
#  |  #
#  |  #
#  |  #
#  |  #
#  *  #
#######
