#############
#@          #
#|          #
#|          #
#|          #
#|          #
#|          #
#|          #
#*          #
#############
