#############
#           #
#@==%=!=%==@#
#   |   |   #
#   |   |   #
#   %=v=%   #
#   | | |   #
#   >=v=<   #
#     *     #
#############
